.............
.....E.E.E...
.............
.BBB.SSSS....
.BBB.SSSS....
.BBB.SSSS....
.BBB.........
......WWW....
......WWW....
.....GGGGG...
.....GIIIG...
.....P.HP...E
.............
